JARVIS	JH AA R V AH S
BRING	B R IH NG
ME	M IY
COFFEE	K AA F IY
FROM	F R AH M
THE	DH AH
KITCHEN	K IH CH AH N
WASH	W AA SH
AND	AH N D
DRY	D R AY
MY	M AY
CLOTHES	K L OW DH Z
GET	G EH T
TO	T UW
AVENGER	AH V EH N JH ER
BASE	B EY S
HEY	HH EY
SAYA	S AA EY AA
SAYA(2)	S AA EY AH
SAYA(3)	S AH EY AA
SAYA(4)	S AH EY AH
