BACK	B AE K
FORWARD	F AO R W ER D
FULL	F UH L
HALF	HH AE F
LEFT	L EH F T
MOVE	M UW V
RIGHT	R AY T
SPEED	S P IY D
STOP	S T AA P
HEYSAYA	HH EY S AA EY AA
HEYSAYA(2)	HH EY S AA EY AH
HEYSAYA(3)	HH EY S AH EY AA
HEYSAYA(4)	HH EY S AH EY AH
HEYSAYA(5)	HH EY S AA Y AA
HEYSAYA(6)	HH EY S AH Y AA
HEYSAYA(7)	EY S AH Y AA
HEYSAYA(8)	EY S AA Y AA
HEYSAYA(9)	EY S AA EY AA
HEYSAYA(10)	EY S AH EY AA
HEYSAYA(11)	EY S AA EY AH
HEYSAYA(12)	EY S AH EY AH
PLAY	P L EY
QUIT	K W IH T
